repair	hyper	capability
confrontation	hyper	crisis
company	hyper	user
administration	hyper	leader
conspiracy	hyper	obstruction
warming	hyper	action
sheik	hyper	cleric
city	hyper	area
slum	hyper	district
fat	hyper	food
fame	hyper	status
program	hyper	system
baseball	hyper	game
custom	hyper	agency
foe	hyper	opponent
brain	hyper	tissue
game	hyper	play
brainstem	hyper	tissue
minibus	hyper	bus
breathing	hyper	ability
yeast	hyper	organism
arrest	hyper	operation
allegation	hyper	statement
news	hyper	interview
blaze	hyper	fire
food	hyper	source
deal	hyper	agreement
marine	hyper	force
firefighter	hyper	crew
navy	hyper	corps
aircraft	hyper	plane
holding	hyper	company
coach	hyper	person
computer	hyper	property
documentary	hyper	film
university	hyper	institution
investigator	hyper	agent
grant	hyper	aid
overfishing	hyper	fishing
autopsy	hyper	study
dictator	hyper	strongman
feedback	hyper	note
sultan	hyper	figure
penalty	hyper	sanction
mail	hyper	message
poll	hyper	survey
cancer	hyper	disease
CEO	hyper	executive
diabetes	hyper	disease
oil	hyper	fuel
protest	hyper	resistance
brent	hyper	oil
negotiation	hyper	discussion
song	hyper	music
indictment	hyper	charge
animation	hyper	production
website	hyper	source
deadlock	hyper	clash
race	hyper	contest
commissioner	hyper	ambassador
state	hyper	region
