Missouri	synonym	Mo
participant	synonym	party
subject	synonym	topic
planning	synonym	policy
choice	synonym	option
professor	synonym	scholar
Sept	synonym	September
Rudolph	synonym	Rudy
honor	synonym	honour
sen	synonym	senator
defense	synonym	defence
Shia	synonym	Shiite
nation	synonym	country
Addou	synonym	Addow
Nov	synonym	November
collaboration	synonym	cooperation
Oct	synonym	October
LTTE	synonym	tiger
veteran	synonym	vet
Mahdi	synonym	Mehdi
program	synonym	programme
percent	synonym	cent
seat	synonym	place
Wolverine	synonym	Michigan
world	synonym	globe
Haniya	synonym	Haniyeh
accord	synonym	treaty
corporation	synonym	firm
spot	synonym	position
Bande	synonym	Banda
manufacturer	synonym	maker
Howard	synonym	Goward
Maryland	synonym	Md
Butler	synonym	Butner
proceedings	synonym	proceeding
body	synonym	panel
measure	synonym	bill
child	synonym	infant
organization	synonym	organisation
cabinet	synonym	government
tv	synonym	television
company	synonym	firm
percent	synonym	percentage
city	synonym	stronghold
infant	synonym	baby
worker	synonym	laborer
child	synonym	baby
feature	synonym	film
home	synonym	family
breakup	synonym	break
purpose	synonym	intent
savings	synonym	synergy
case	synonym	lawsuit
article	synonym	study
state	synonym	nation
Paterson	synonym	Patterson
role	synonym	function
Youni	synonym	Yune
agency	synonym	way
accomplice	synonym	group
issue	synonym	matter
area	synonym	district
commitment	synonym	dedication
body	synonym	widebody
show	synonym	appearance
cofounder	synonym	founder
price	synonym	cost
newspaper	synonym	paper
voting	synonym	vote
holding	synonym	company
consumption	synonym	expenditure
election	synonym	vote
union	synonym	marriage
researcher	synonym	scientist
percentage	synonym	share
fee	synonym	tuition
part	synonym	role
college	synonym	school
butchery	synonym	carnage
board	synonym	panel
death	synonym	destruction
negotiator	synonym	envoy
administration	synonym	government
petroleum	synonym	oil
advertising	synonym	campaigning
revolt	synonym	rebellion
agency	synonym	association
battle	synonym	struggle
authority	synonym	government
reporter	synonym	newsman
case	synonym	trial
animation	synonym	excitement
CAT	synonym	CT
moon	synonym	month
commander	synonym	gen
voter	synonym	resident
concertgoer	synonym	fan
guide	synonym	cookbook
condition	synonym	disease
contender	synonym	challenger
corps	synonym	force
discussion	synonym	dialog
godfather	synonym	leader
discussion	synonym	forum
gunman	synonym	sniper
chamber	synonym	committee
imagery	synonym	model
earnings	synonym	profit
madrasa	synonym	madrassa
award	synonym	honor
madrassa	synonym	school
attorney	synonym	lawyer
marine	synonym	navy
plan	synonym	program
meeting	synonym	talk
couple	synonym	pair
Michael	synonym	Mike
