Amazon	coord	eBay
Sunday	coord	Monday
DaimlerChrysler	coord	Mercedes
estimate	coord	expectation
Monday	coord	Friday
battle	coord	race
chase	coord	race
black	coord	hispanic
Afghanistan	coord	Pakistan
Chrysler	coord	NYSE
department	coord	government
flight	coord	trip
idea	coord	plan
official	coord	spokeswoman
barrel	coord	gallon
organization	coord	effort
journalist	coord	videographer
phrase	coord	description
lady	coord	wife
researcher	coord	doctor
scenario	coord	intent
report	coord	review
finding	coord	observation
blaze	coord	wildfire
fraud	coord	scandal
Boeing	coord	Tractor
plot	coord	proposal
condition	coord	argument
study	coord	test
culture	coord	habit
war	coord	invasion
feedback	coord	note
flaw	coord	issue
UK	coord	Argentina
information	coord	matter
Aug	coord	September
reporter	coord	journalist
wife	coord	mother
study	coord	research
Brady	coord	Bruschi
Washington	coord	Tehran
Missouri	coord	Arkansas
Dollar	coord	Lenox
Bernardini	coord	Albertrani
draft	coord	resolution
Spain	coord	Austria
editorial	coord	periodical
parent	coord	family
capital	coord	centre
Patriot	coord	Dolphin
Pittsburgh	coord	Steeler
Prado	coord	Albertrani
profit	coord	revenue
Syria	coord	Lebanon
representative	coord	publicist
SID	coord	COT
softie	coord	gentleman
singer	coord	actress
stake	coord	cup
typhoon	coord	landslide
stewardship	coord	charge
Jose	coord	Seattle
Sunday	coord	Friday
unrest	coord	horror
security	coord	justice
oil	coord	gas
fighting	coord	guerrilla
album	coord	cd
conscience	coord	culture
challenger	coord	candidate
contender	coord	player
command	coord	domination
remark	coord	reference
course	coord	strategy
target	coord	commitment
Golen	coord	Mccauley
challenge	coord	task
performance	coord	role
pressure	coord	temperature
